X->E
L->T
I->A
W->O
F->I
G->N
Q->S
O->H
C->R
B->D
P->L
S->C
T->U
Z->M
R->W
A->F
K->G
E->Y
H->P
U->B
M->V
N->K
J->J
V->X
Y->Q
D->Z

Manual Replace
s<->r
i<->h
f<->y
m<->w
g<->c
n<->m
h<->l
l<->h
m<->n
k<->v
f<->m
